######
#   .#
# ## #
#    #
# ## #
# ## #######
#.$ @      #
# ## ## ## #
#      $   #
# ## #######
# ## #
#    #
######